#################################################################################
#...#.......#.....#.......#...#.........#.......#.......#..q............#...#...#
#.#.#.#.###.###.#.#.#####.#.#.#.#######.#####.#.###.###Y###.#######.#####I#.#.#.#
#.#.#.#...#.....#.#.....#.#.#...#...#...#.....#.....#.#.....#.......#...#.#...#.#
#.#.#####.#######.#####.#.#.#####.#.#.#.#.#####.#####.###.#######.###N#.#.#####.#
#.#....f#.....#.#.#.#...#.#...#...#...#.#...#...#...#...#.#.....#.#...#.#...#...#
#.#####.###.#.#.#.#.#.###.#####.###########.#####.#.#.###.#.###.###.###.###.#.###
#.....#...#.#.#.#...#...#.....#.#.......#...#...#.#.#.....#.#.#.......#.....#.F.#
#####.###.###.#.###.###.#####.#.#.#####.#.###.#.#.#.#######.#.#############.###.#
#...#.#.#.#...#.....#.....#...#.#...#...#...#.#.#.#.......#.#.....#.......#.#a..#
#.#.#.#.#.#.###.#####.#####.###.#.###.#.#.#.#.#.#.#######.#.#.#.###.#####.###.###
#.#...#.#...#.#...#...#.....#...#.#...#.#.#...#.#.....#...#.#.#...#.....#.....#.#
#.#####.#####.#.###.###.#######.#.#.###.#######.#.#####.#.#.#####.#####.#######.#
#...#.........#.#...#.#.......#...#.#.#.#.....#...#...#.#.#...........#.#.......#
###.#########.#.#.###.#######.#.###.#.#.#.###.#####.#.#.###########.###.#.#####.#
#...#.....#...#.#.......#...#.#.#...#.#.#.#.....#...#...#...#.......#...#...#...#
#.#.#.###.#.###.#######.#.###.#.#.###.#.#.#####.#.#####.#.#.#.#######.#####.#####
#.#.#...#.#.....#.#.......#...#.#.#.#...#...#.....#.....#.#.......#...#...#.....#
#.#####.#.###.###.#.#######.#####.#.#.###.#.#########.###.#########.###.#.#####.#
#.......#...#.....#.#.......#.....#...#.#.#.....#...#.#.#...#.....#.#...#.......#
#.#######.#.#######.#.#########.###.###.#.#####.#.#.#.#.###.#.###.#.#.#.#######.#
#...#...#.#.......#.#.#...L...#.#.#...#.#...#.#...#.#.....#.#.#.#.#.#.#...#...#.#
#.###.#.#####.###.#.#######.#.#.#.###.#.###.#.#####.#####.#.###.#.#.#####.#.#.###
#.#...#.....#...#.#.......#.#...#.......#.#.......#...#...#.#...#...#.....#.#...#
#.#.#######.###.#.#######.#.###########.#.#######.###.#.###.#.#.#####.#.###.###.#
#.#.#.#.....#...#...#.....#.........#...#.#...#.....#.#...#.#.#.....#.#.#...#.#.#
###.#.#.#########.###.###########.#.###.#.#.#.#.#####.###.#.#####.#.#.###.###.#.#
#...#...J.#.......#...#.........#.#...#.#...#...#.....#.#.#.#.....#...#...#s..#.#
#.#######.#.#####S#.#######.###.#.###.###.#######.#####.#.#.#.#####.###.#####.#.#
#.#.....#...#...#.#.#.....#.#.#.#...#...#...#.#...#.......#.#...#...#...#.....#.#
#.#T###.#####.#.###.###.#.#.#.#.#.#####.###.#.#.#########.#.###.#####.###.#####.#
#.#.#...#.....#.#...#...#...#...#.#...#.#.#.#.#.#.......#.#...#.......#.....#..w#
#.#.#.###.#####.#.###.#######.#####.#.#.#.#.#.#.#.#####.#####.#.###########.#.#.#
#...#.#.B.#...#.#.#.#...#.#...#.....#.#.#.#.#.#.#.#r..#.....#.#.#...#.......#.#.#
#.###.#.###.#.#.#.#.#.#.#.#.###.#####.#.#.#.#.#.#.#.#######.#.#.#.#.#.###.###.#.#
#...#.#...#.#.#...#...#.#.#.#.......#...#.#...#...#.......#.#.#.#.#.#.#...#...#.#
###.#.###.###.#########.#.#.#.#####.#####.###.#####.#####.#.#.#.#.#.#.#####.###.#
#...#...#...#.....W...#.#.#.#c#...#.....#...#.....#.#.....#...#...#...#...#...#.#
#.###.#####.###.#####.#.#.#.###.#.#####.#.#.#####.###.###.#############.#.###.#.#
#o..#...........#.......#.......#......@#@#...........#.................#.....#.#
#################################################################################
#...#.....#...#.........#.............#@#@........#.....#............j....#...#.#
#.#.#P###.###.#.###.###.#.###.#######.#.#.#####.###.#.#.###.#.###.#######.#.#.#.#
#.#...#.#...#.#.#.#...#.#...#.#.....#.#.#.#...#.....#.#...#.#.#...#..t..#...#...#
#G#####.###.#.#.#.###.#.#.###.#.#.#.#.#.#.###.#######.###C###.#.###.###.###.#####
#.#...#...#.#.#.....#.#.#.#...#.#.#.#.#.#...#.....#...#.#...#.#.#...#...#...#...#
#.#.###.#.#.#.#####.#.#.###.#####.###.#.###.#.#####.###.###.#.###.###.#######.#.#
#.#.....#.#.#...#...#.#...#.....#...#.#.#.....#...#.#.....#.#.......#.#.......#.#
#.#######.#.#.###.###.###.#####.###.#.#.#.#####.#.#.#.#####.#.#####.#.#.#######.#
#.......#...#...#.#.#.#.#.....#...#...#.#...#...#.#.#.....#.#.#...#.#...#.......#
#.#####.#.#####.#.#.#.#.#####.###.#.###.#.###.###.#.#####.#.###.#.#######.#####.#
#.#...#.#.....#...#.#.#.....#.....#.#...#.#...#.#.#.....#...#...#.........#.....#
#.#.#.#.#####.#.###.#.#####.#######.#.#.#.#.###.#.#.###.#.###.#############.#####
#...#.#.#.....#.....#.....#...#.....#.#.#.#.#.....#.#.#.#.#...#...#.O.#...#b..#.#
#####.#.###.###.#########.###.#.#####.#.#.#.#.#####.#.#.#.#.###.#.###.#.#.###.#.#
#...#.#...#...#.#.........#...#...#...#.#.#.#...#.....#.#...#...#..d#.#.#...#.#.#
#.###.###.###.#.#.#########.#.###.#.###.###.###.#######.###.#.#####.#.#.#.###.#.#
#.#.X.#.#.#...#.#...#.#.....#...#.#...#.#...#.....#.....#...#.#...#.#...#...#...#
#.#.###.#.#.###.###.#.#.###.###.#.#.#.#.#.#.#####.#.#####.###.###.#.#######.###.#
#.......#.#.#.#...#.#...#.#.#...#.#.#.#.#.#.#...#.#.#...#...#...#k#.......#...#.#
#.#####.#.#.#.#.###.###.#.#.#####.#.#.###.###.#.#.#.#.#.#######.#.#######.#.#.#.#
#.#...#.#.#.#...#...#.#...#.#...#.#.#...#.#...#.#...#.#.....U.#.#.....#...#.#...#
#.#.#.###.#.#.###.#.#.###.#.#.#.#.#####.#.#.###.###.#.#########.#.#####.#########
#.#.#.....#.#.#...#.#.#...#...#...#...#.#.....#...#.#...#......h#.......#.......#
#.#.#######.###.###.#.#######.#####.#.#.#########.#.###.###.#####.#######.#####.#
#.#.#...#.....#.#...#u......#...#...#.R.#.......#.#.#...#...#...#........x#...#.#
#.#.#.#.#####.#.#.#########.###.#.#.###.#.#####.#.###.###.###.#Z###########.#.#.#
#.#...#...#.#...#...#...#.E.#.#.#.#.#...#...#...#...#.#.......#.#.....#....g#.#.#
#K#######.#.#####.###.#.#.###.#.#.#.#.#####.#.#####.#.#####.###.#.###.###.#####.#
#.#z....#.#.......#..v#.#...#.#.#.#.#...#...#.....#.#.#..e#...#.#...#...#.......#
#.#.###.#.#########.###.###.#.#.#.#.###.#.#######.#.#.#.#.###.#.#.#####.#.#######
#.#.#...#.......#...#.#.....#.#.#.#.#...#...#.......#...#...#.#...#...M.#.......#
#.###H#.#######.#.###.#######.#.###.#.###.#.###############V#######.###########.#
#...#.#.#.....#.#.....#.........#...#l#.#.#...#.........Q.#.........#.......#...#
###.#.###.#.###.#####.#.#####.###.###.#.#####.#.#######.#############.#####.#.###
#.#.#.....#.#.....#.#.#.#...#...#.#.....#.....#.#...#...#.......#.........#.#..p#
#.#.#######.#.###.#.#.###.#.###.#.#####.#.###.#.###.#.###.###.#.#.#######.#.###.#
#.#...D.....#.#.....#m....#.#...#...#.#.#y#...#.#...#n..#...#i#.#.#.......#.#...#
#.#########.#.#############.#.#####.#.#.#.#####.#.#.###.###.#.###.#.#########.###
#...........#...............#.......#...#.........#...#.....#.....#.......A.....#
#################################################################################
